###########   ##########
#..@......#####........#
#..........i..TT.......#
#.T.......#####...P....#
#.........#   #........#
####...####   #...I....#
   #...#      #........#
####...####   #........#
#.........#   #...x....#
#..ppppp..#   #........#
###########   ##########
