                  ###                
###########   ##########             
#..@......#####........#             
#..............T.......#             
#.T.......#####........#   ###       
#.....x...#   #........#  #####      
####...####   #........#  #####      
   #...#     ##........#   ###       
####...####  #.........#             
#.........#  #...x.....#             
#.........#  ##........#             
###########   ##########             
  #####                              
